1 1 1 1 1 1 1 1 1 1 1 1 1 1 1
1 0 0 0 1 1 0 0 0 1 1 0 0 0 1
1 0 s 0 0 0 0 r 0 x 0 0 b 0 1
1 0 0 0 1 1 0 0 0 1 1 0 0 0 1
1 1 1 1 1 1 1 1 1 1 1 1 x 1 1
1 1 0 1 1 1 1 r 1 1 1 1 x 1 1
1 0 0 0 1 1 0 0 0 1 1 0 0 x 1
1 0 x 0 0 0 0 # 0 0 0 0 0 x 1
1 0 0 0 1 1 0 0 0 1 1 0 0 x 1
1 1 0 1 1 1 1 0 1 1 1 1 0 1 1
1 1 0 1 1 1 1 0 1 1 1 1 0 1 1
1 0 0 0 1 1 0 0 x 1 1 x x x 1
1 0 r 0 r r 0 r x x x x g x 1
1 0 0 0 1 1 0 0 x 1 1 x x x 1
1 1 1 1 1 1 1 1 1 1 1 1 1 1 1