x x x x x x x g x x x x x x x
x x x x x x x x x x x x x x x
x x x x x x x x x x x x x x x
x x x x x x x x x x x x x x x
x x x x x x x x x x x x x x x
x x x x x 0 0 0 0 0 x x x x x
x x x x x 0 0 r 0 0 x x x x x
g x x x x 0 r s r 0 x x x x g
x x x x x 0 0 r 0 0 x x x x x
x x x x x 0 0 0 0 0 x x x x x
x x x x x x x x x x x x x x x
x x x x x x x x x x x x x x x
x x x x x x x x x x x x x x x
x x x x x x x x x x x x x x x
x x x x x x x g x x x x x x x