x x x x x x 1 1 1 x x x x x x
x x x x x x 1 g 1 x x x x x x
x x x x x x 1 0 1 x x x x x x
x x x x x 1 1 0 1 1 x x x x x
x x x x x 1 0 0 0 1 x x x x x
x x x x x 1 r r r 1 x x x x x
x x x x x 1 0 r 0 1 x x x x x
x x x x x 1 0 0 0 1 x x x x x
x x x x x 1 1 x 1 1 x x x x x
x x x x x x 1 0 1 x x x x x x
x x x x x x 1 r 1 x x x x x x
x x x x x x 1 0 1 x x x x x x
x x x x x x 1 0 1 x x x x x x
x x x x x x 1 s 1 x x x x x x
x x x x x x 1 1 1 x x x x x x